1======================2
#!.....................#
#.#.1======.=======2.#.#
#.#.#!.............#.#.#
#.#.#.1===.====2.#.#.#.#
#.#.#.#......!.#.#.#.#.#
#.#.#.#.1=++=2.#.#.#.#.#
4.#.#.#.#xoox#.#.#.#.#.3
0.......#oooo#.....o...0
2.#.#.#.#xoox#.#.#.#.#.1
#.#.#.#.3====4.#.#.#.#.#
#.#.#............#.#.#!#
#.#.3======.=====4.#.#.#
#.#..................#.#
#.#.=======.========.#.#
#......P...............#
3======================4
